XXXXXXXXXX
XE_o__o__X
X_XXX_XXoX
X_o_o_o__X
X_XX_XX__X
Xo_o__oX_X
X_XXX_XXoX
X__o_o_o_X
X_XXXXXXXX
X_o___o_SX
XXXXXXXXXX